1111111111111111111112222212-
1111111100011111111122222222-
1111111110011111111122222222-
1111100000011111111122222222-
1111111110011111100000111222-
1111100000011111111122222222-
1112222221222221122222222222-
2222222222222222222222222222-
1111111111111111111112222222-
1111111111111111110011222222-
1112222221222221122222222222-
1111111111111111111111111112-
1111111111111111110011222222-
1112222221222221122222222222-
2222222222222222222222222222-
1111111111111111111112222222-
1111111100011111111122222222-
1111111110011111100000111222-
1111100000011111111122222222-
1112222221222221122222222222-
2222222222222222222222222222-
1111111111111111111112222222-
1111111111111111110011222222-
1112222221222221122222222222-
1111111111111111111111111112-
1111111111111111111111111112-
0000000000000000101010000112